EEEE2EE1EEEE1ETE
2EE4EEE31EE2EE12
TE1EEEEE3EE1EEE3
EEEEE21EEETE13EE
2EE3EEEEEEEE3EE2
EE31ETEEE12EEEEE
3EEE1EE3EEEEE1ET
21EE2EE13EEE4EE2
ETE1EEEE1EE2EEEE
