EEEEEEEEEEEEEEE411E
1TEE4EEEEEEEEEEE1T1
EEEEEEEEEEEEE3EE111
4EEEEEEEEEEEEEEEEEE
EEEEEEE3EEEEEEEEEEE
EEEEEEEEEEEEEEEE3EE
EEE3EE2EEE2EEEEEEEE
EEEEEEEEETEEEEEEEEE
EEEEEEEE2EEE2EE3EEE
EE3EEEEEEEEEEEEEEEE
EEEEEEEEEEE3EEEEEEE
EEEEEEEEEEEEEEEEEE4
111EE3EEEEEEEEEEEEE
1T1EEEEEEEEEEE4EET1
E114EEEEEEEEEEEEEEE
