E3EEEE1E4WWEEEEE4EEE
3EEEEEEEEWWE2EEEEEE3
EEEEEE1EEWWEEEEEEEEE
E1E4EEE2EWWEEEEEE11E
EEEEEEEEEWW3EEEEEEEE
3EEEEE1EEWWEEEEEEEEE
EEEEEEE4EWWEE1EEEE2E
E2EEEEEEEWWEEEEEEEEE
EE1EEEEEEWWEEEEEEEE1
3EEEEEEEEWWE2EEEEEEE
EEEEEEE2EWWEEEEEEEE3
1EEEEEEEEWWEEEEEE1EE
EEEEEEEEEWWEEEEEEE2E
E2EEEE1EEWWE4EEEEEEE
EEEEEEEEEWWEE1EEEEE3
EEEEEEEE3WWEEEEEEEEE
E11EEEEEEWWE2EEE4E1E
EEEEEEEEEWWEE1EEEEEE
3EEEEEE2EWWEEEEEEEE3
EEE4EEEEEWW4E1EEEE3E
