EEWEEE1EEE1EEE1EEEEE
ETWEEEEE2EEEEEEE2EE1
WWW2EEEEEE2E1EEE3TEE
EEEEEEEEEEEEEEEEEEEE
EEEEEEE432T2EEEEEEEE
EEEEEEEE2T234EEEEEEE
EEEEEEEEEEEEEEEEEEEE
EET3EEE1E2EEEEEE2WWW
1EE2EEEEEEE2EEEEEWTE
EEEEE1EEE1EEE1EEEWEE
