E11111EEEE
WWWWWWWWWE
44422EEEEE
2WWWWWWWWW
42EE2E2EEE
EEEEEEEEE3
EEEEEEEEEE
3EEEEEEEEE
EEE2E2EE24
WWWWWWWWW2
EEEEE22444
EWWWWWWWWW
EEEE11111E
