ETTTTTTTTTTTTTE
WWWWWWWWWWWWWWE
T1EE2EE3E2E1EEE
11EEEEE4EEEEE11
EEE1E2E3EE2EE1T
EWWWWWWWWWWWWWW
ETTTTTTTTTTTTTE
