EWEEEW11EWEEE
EWEWEW1WEW2WE
EWEWEW1WEW2WE
EWTWTW1WTWTWE
EW2WEW1WEWEWE
EW2WEW1WEWEWE
EEEWE11WEEEWE
