EEEEEEEEEEEEEEEEEEEEEEEEEEEE
EWEEEEWE4EEEEEEEEEEEEEEEEEEE
1EEEEEEEEEEEEE1EEEEETEEEEEEE
2EEEWEEETEEEEEEEEEEEEEEEEEEE
EEEEEEEEEEEEEEEEEEEE3EEEEEEE
1EEEEEEEETEEEE1EEEEEEEEEEEEE
EEEEEEEEEEEEEEEEEEEEEEEEEEEE