EEEEEEEEEEEEEEE
TEEEEEEEEEEEEEE
EEEEEEEEEEEEEEE
EEEWWWEEEEEEEEE
EEEEEEEEEEEEEEE
WWWWWWWWWWWEEEE
EEEEEEEEEEEEEEE
EEEEEEEEEEEEEEE
EEEETTEEEEEEEEE
EEEEETEEEEEEEEE
EEEEEEEEEEEEEEE
EEEEEEEEEEEEEEE
WWWWWWWWEEEEEEE
EEEEEEEEEEEEEEE