EEE1EEEEEEEEEEEEEE4E
3EEEEEE1EEEE2EEEEE44
EE1EEEEEEEEEEEE2EEEE
EEEEEEEEEEEE2EEEEEEE
E3EEE1EEEEEEEEEEEEEE
EEEEEEEEEEE3EEE1EEEE
EEEE2EEEEEEEEEEEEEEE
