EEEEWEEEEEEEEEE
EEEEWEEEEEEEEEE
EEEEWEEEEEEEEEE
EEEEWEEEEWEEEEE
EEEEEEEEEWEEEEE
EEEEETTEEWEEEEE
EEEEETTEEWEEEEE
EEEEETTEEWEEEEE
EEEEEEEEEWEEEEE
EEEEEWEEEEEEEEE
EEWEEEEEEEEEEEE
EEEEEEWEEEEWEEE
EEEEEEWEEEEEEEE
EEEEEEEEEEWEEEE