EEEEEE11EW4TTTE
WWWWWWW1WWWWWWW
2EEEEEE1EEEEET2
1EEEEEEEEEEEEEE
111EEEEEEEEEEEE
111EEEEEEEEEEEE
EEEEEEEEEEEEEEE
