EE4EWEEE111EEEE
EE11WE11EEEE11E
EE22WEEE111E2EE
EE33WE22EWEE2EE
E111EE33EWE11EE
EEEEETTEEWE222E
EEEEETTEEWEE11E
E33EETTEEWEEEEE
EE44EEEEEWEEEEE
E44EEWEE333EEEE
EEW1111EE22EEEE
E22EEEWEEEEWEEE
EEEEEEWEEEE111E
EE444EEEEEWEE1E