E12EEEEEEEEEEEE
EEEWE2EEEEEEEE
E1EE1EEE1EEEEEE
EEEE1EEE2EEEEEE
EEWETE2EETEEEEE
EE1EE22EEEEEEEE
EEWE1EE22TEEEEE
EEEETEEE222EEEE
EEE11EEWWWWWWWW
EEWEEEEWEE1111E
EE11EEEWEEEEEEE
EEWEEEEWEE2222E
EE11EEEWEEEEEEE
EWWE1EEWEE3333E