EEEEEEEEEEEEEEE
222222222EEEEEE
EET444444EEEEEE
333333333EEEEEE
EEEEEEEEEEEEEEE
EEEEEEEEEEEEEEE
EEEEEEEEEEEEEEE
EEEEEEEEEEEEEEE
EEEEEEEEEEEEEEE
EEEEEEEEEEEEEEE
EEEEEEEEEEEEEEE
EEEEEEEEEEEEEEE
EEEEEEEEEEEEEEE
EEEEEEEEEE44EEE
E11111111111EEE
E33333333333EEE
E1111111111111E
E22222222222TEE
E1111111111111E