EEEEEEEEEEEEEEE
EEEWEEEEEEEEEEE
EEEEEEEEEEEEEEE
EEEEEEEEEEEEEEE
EEWETEEEETEEEEE
EEEEEEEEEEEEEEE
EEWEEEEEETEEEEE
EEEETEEEEEEEEEE
EEEEEEEWWWWWWWW
EEWEEEEWEEEEEEE
EEEEEEEWEEEEEEE
EEWEEEEWEEEEEEE
EEEEEEEWEEEEEEE
EWWEEEEWEEEEEEE