EEEEEEEEEEEEEEE
WWWWWWWWWWWWWWE
EEEEEEEEEEEEEEE
EWWWWWWWWWWWWWW
EEEEEEEEEEEEEEE
WWWWWWWWWWWWWWE
EEEEEEEEEEEEEEE
EWWWWWWWWWWWWWW
EEEEEEEEEEEEEEE
WWWWWWWWWWWWWWE
EEEEEEEEEEEEEEE
EWWWWWWWWWWWWWW
EEEEEEEEEEEEEEE
EEEEEEEEEEEEEEE