EEEEEEEEEEEEEEEEEEEEEE
1WEEEEWE4EEEEEEEEEEEEE
111EE1EEEEEEEE1EEEEEEE
2EEEWEEETEEEEEEEEEEEEE
EEEEEEEEEEEEEEEEEEEE3E
1EEEEEEEETEEEE1EEEEEEE
EEEEEEEE1EEE1EEEEEEEEE