EEEEEEEEEEEEEEEEEEEEEE
EWEEEEWE4EEEEEEEEEEEEE
1EEEEEEEEEEEEE1EEEEEEE
2EEEWEEETEEEEEEEEEEEEE
EEEEEEEEEEEEEEEEEEEE3E
1EEEEEEEETEEEE1EEEEEEE
EEEEEEEEEEEEEEEEEEEEEE