EEEEEWEEEEEEEEE
EETEEWEEEEEEEEE
WWEEEEEEEEEEEEE
EEEEEEEEEEWWEEE
EEEEEWEEEEEEEEE
EEEETWEEEEEEEEE
EEEEEEEEEEWWEEE
EWWEEEEEEEEEEEE
EEEEEEEEWWEEEEE
EEEWWEEEEEEEEEE
EEETEEEEETEWWEE
EEEEEEEWWWEEEEE
EEEEEEEEEEEEEEE
EEWWWEEEEEEEEEE