EWEEWEEEWEEEEEE
EWEEWWWEWEEEEEE
EWEEEEEEWEEEEEE
EEEEWWWEWEEEEEE
EEEEWEEEWEEEEEE
WWWWWEEEWEEEEEE
EEEEEEEEWEEEEEE
EEEEEEEEWEEEEEE
EEEEEEEEWEEEEEE
EEEEEEEEWWWWWWW
EEEEEEEEEEEEEEE
EEEEEEEEEEEEEEE
EEEEEEEEEEEEEEE
EEEEEEEEEEEEEEE