EEEEWEEEEEEEEEE
EEEEWEEE1EEEEEE
EEETWEEE1EE31EE
WWWWWEEEEEE3EEE
EE1EEETE1EE2EEE
EE2EEEEEEEE4EEE
EEE34EE2EE12EEE
EEEEEEE1EEEEEEE
EE1EEEE1EE11EEE
EEEEEE1EEEEEEEE
E1EEEE333EEEEEE
EEE2EEEE1212121
22E44EEEEEEEEEE
EEEEE111111111E