EEEEEEEEEWEEEEE
EEEEEEEEEWEEEEE
EEEEEEEEEWEEEEE
EEEWETEEEEEEEEE
EEEEEEEEEEEEEEE
EEETEEWWTEEEEEE
EEEEEEWWEEEEEEE
EEEWWEEEEEEEEEE
EEETEEEEEETEEEE
WWEEEEEEEEEEEEE
EEEEEWWEWWWWWWW
EEEEEEEEWTEEEEE
EEWWEEEEWEEEEEE
EEEEEEEEWEEEEEE